0000000000000000000
0101111111111101111
0101000101010001010
0111010101011101010
0101010101000001010
0101110101011101010
0101000101010101010
0101011101110111110
0101010100010000000
0101010101010101110
0001010001010101000
0111010111011101110
0001010100010000010
0101111101011111110
0100010101010000010
0111010111011111010
0101010101010001010
0101110101110111010
0000000000000000000