0000000000000000000
0111011101111111111
0101010001000100000
0101011101110111110
0101000100010001010
0101111111111111010
0100010001000001010
0111010101011111010
0100010101000101000
0111011101010101010
0100010000010000010
0101111111110111110
0101000000010001000
0101010101011101110
0101010101000100010
0101011101111101010
0101000100010101010
0111111111010111110
0000000000000000000