0000000000000000000
0111111111011101111
0100010001000101010
0111010101010111010
0101010101010101010
0101010111110101010
0001000101000100000
0111011101111111110
0100010000000001000
0111011101011101010
0001010101010101010
0111011101110101110
0001000101000100010
0111010101011101110
0100010101010001000
0111111101011111110
0001000101000000010
0111011111011111110
0000000000000000000