0000000000000000000
0101111111111111111
0101000100000100010
0111011101011101010
0100010001010101010
0111011111010111010
0000000001010001010
0111110111010111110
0100010100010100010
0101111111111101110
0101000001010000000
0101110101011111110
0101010101010000000
0101010101010111110
0100000101010101000
0101011111011101110
0101010001000101000
0111111101110101110
0000000000000000000