0000000000000000000
0111010111111101111
0100010001000001000
0111111111111101110
0001000101010001010
0111110101011101010
0100010001010000010
0111010111010101110
0101000000010101000
0101110101111101010
0000010100010001010
0111010111111101010
0100010001000001010
0101110101111111110
0101000100000101010
0111011101011101010
0100010101010000010
0111110111111111010
0000000000000000000