0000000000000000000
0111011111111111111
0101000100010000010
0101011101111111010
0101010100010001010
0101110111011101010
0100000001010000010
0111110111011111010
0000010000010001010
0111011111111101010
0001010000010000010
0111111111010111110
0001010000010100000
0101010101111111110
0101010101010001000
0101011101010111110
0101000101000001000
0111011101111101110
0000000000000000000