0000000000000000000
0111010111011101111
0101010001010001000
0101011111011111010
0101010000010001010
0101011111110111110
0001000100000000000
0101111101011111110
0100000101000100000
0101111111011101010
0100010001010001010
0111110111010101110
0000000100010101000
0111110101111101110
0101010101000001010
0101011111011101010
0001000101010000010
0111011101111111110
0000000000000000000