0000000000000000000
0111111111011111111
0100000100010100010
0111010101110101010
0100010001000101010
0111111111110101110
0100010001000001010
0111010101111111010
0100010100010100010
0101111101010111010
0101010101000001000
0101010111110111010
0001000001000101010
0101110101011101010
0101000101010001010
0111111101111101110
0001000101010101010
0111110111010101010
0000000000000000000