0000000000000000000
0101111111110111111
0101000001010100010
0111110111010111010
0000000100010000010
0111111101011111110
0100000001000000010
0101111101111111110
0101000001000000000
0101111111011111110
0101000001010100010
0101011101110101110
0101010100000101000
0101010111111101110
0101010000000000010
0101011111110111010
0100000000010101010
0111111111111101110
0000000000000000000
