0000000000000000000
0111011111110101111
0101010100010100010
0101110101110101110
0100010101000101000
0101010101110111010
0101000001010100010
0111111111011111110
0101000001000000010
0101010111110111010
0101010001010100010
0101111101010101110
0101010101000101010
0101010101011111010
0001010001000101000
0111011101111101010
0101000100000101010
0101110111111101110
0000000000000000000